111111
10E001
1000C1
1P1111
111111