11111111111111111111111111111111111
1E1100000000000C00000C0000000000011
10100101001000001010010000000101011
10100100101010100010010000000101011
1P000100C00C0000000000000000000C111
11111111111111111111111111111111111