	111111
	10E001
	1100C1
	101101
	100001
	1P0001
	111111