111111
10E1P1
110001
1010C1
111111