11111111111111111111111111111111111111111111111111111111111111111111111111111111111111111111111111111111
100000000000000C0000010000000000000000000001000000000000000000000000000000000000001000000000000000000001
10100101001000001010010000000101000000000000000000000000000000000000000000000000001000000000000000000001
1010010010101010001001000000010100000000000000000C000000000000000000000000000000001000000000000000000001
100000000C00C0000000000000000000C00000000001000000000000000000000000000000000000001000000000000000000001
10100100101010100010010000000101000000000001000000000000000000000000000000000000001000000000000000000001
10100100101010100010010000000101000000000001000000000000010000000000000000000000001000000000000000000001
101001000C101010001001000000010100000000000100000000000011000C000000000000000000000000000000000000000001
10000100101010100010010000000101000000000001000000000000010000000000000000000000001000000000000000000001
1P00010010101010001001000000010100C1C100C001000000000000000000000000000000000000000000000000000000000001
10100100101010100010010000000101000000000001000000000000000000000000000000000000000000000000000000000001
10100100101010100010010000000101000000000001000000000000000000E00000000000000000001000000000000000000001
11000001000000000000011111111111111111111111111111000000000000000000000001110000110010000000000000000001
100000000C00C0000000000000000000C00000000001000000000000000000000000000000000000001000000000000000000001
10100100101010100010010000000101000000000001000000000000000000000000000000000000001000000000000000000001
10100100101010100010010000000101000000000001000000000000010000000000000000000000001000000000000000000001
101001000C101010001001000000010100000000000100000000000011000C000000000000000000000000000000000000000001
10000100101010100010010000000101000000000001000000000000010000000000000000000000001000000000000000000001
11111111111111111111111111111111111111111111111111111111111111111111111111111111111111111111111111111111