11111111111111111111111111111111111111111111111111111111111111111111111111111111111111111111111111111111
100000000000000C00000C0000000000000000000000000000000000000000000000000000000000000000000000000000000001
10100101001000001010010000000101000000000000000000000000000000000000000000000000000000000000000000000001
10100100101010100010010000000101000000000000000000000000000000000000000000000000000000000000000000000001
10100100101010100010010000000101000000000000000000000000000000000000000000000000000000000000000000000001
10100100101010100010010000000101000000000000000000000000000000000000000000000001010001001110000000000001
10100100101010100010010000000101000000000000000000000000000000000000000000000000000000000000000000000001
10100100101010100010010000000101000000000000000000000000000000000000000000000000000000000000000000E00001
10100100101010100010010000000101000000000000000000000000000000000000000000000000000000000000000000000001
10100100101010100010010000000101000000000000000000000000000000000000000000000000000000000000000000000001
10100100101010100010010000000101000000000000000000000000000000000000000000000000000000000000000000000001
10100100101010100010010000000101000000000000000000000000000000000000000000000000000000000000000000000001
10100100101010100010010000000101000000000000000000000000000000000000000000000000000000000000000000000001
1P0000000C00C0000000000000000000C00000000000000000000000000000000000000000000000000000000000000000000001
10100100101010100010010000000101000000000000000000000000000000000000100101010100010010000000100000000001
10100100101010100010010000000101000000000000000000000000000000000000000000000000000000000000000000000001
10100100101010100010010000000101000000000000000000000000000000000000000000000000000000000000000000000001
10100100101010100010010000000101000000000000000000000000000000000000000000000000000000000000000000000001
10100100101010100010010000000101000000000000000000000000000000000000000000000000000000000000000000000001
10100100101010100010010000000101000000000000000000000000000001001010101000100100000001001010100000000001
10100100101010100010010000000101000000000000000000000000000000000000000000000000000000000000000000000001
10100100101010100010010000000101000000000000000000000000000000000000000000000000000000000000000000000001
10100100101010100010010000000101000000000000000000000000000000000000000000000000000000000000000000000001
10100100101010100010010000000101000000000000000000000000000000000000000000000000000000000000000000000001
10100100101010100010010000000101000000000000000000000000000000000000000000000000000000000000000000000001
10100100101010100010010000000101000000000000000000000000000000000000000000000000000000000000000000000001
10100100101010100010010000000101000000000000000000000000000000000000000000000000000000000000000000000001
10100100101010100010010000000101000000000000000000000000000000000010010101010001001000000111111111000001
10100100101010100010010000000101000000000000000000000000000000000000000000000000000000000000000000000001
10100100101010100010010000000101000000000000000000000000000000000000000000000000000000000000000000000001
10100100101010100010010000000101000000000000000000000000000000000000000000000000000000000000000000000001
10100100101010100010010000000101000000000000000000000000000000000000000000000000000000000000000000000001
10100100101010100010010000000101000000000000000000000000000000000000000000000000000000000000000000000001
10100100101010100010010000000101000000000000000000000000000000000000000000000000000000000000000000000001
10100100101010100010010000000101000000000000000000000000000000000000000000000000000000000000000000000001
10100100101010100010010000000101000000000000000000000000000000000000000000000000000000000000000000000001
10100100101010100010010000000101000000000000000000000000000000000000000000000000000000000000000000000001
11111111111111111111111111111111111111111111111111111111111111111111111111111111111111111111111111111111